13
..............
..............
..............
..............
..............
..............
..............
..............
.............
.x..x.x.....x.
....//.\\.....
..............
.-------------
